2 13 31
###############################
#p     ** *  3 * 2 *  * * *   #
# # # #*# # #*#*# # # #*#*#*# #
#  xb     ***  *  3   * 2 * * #
# # # # # #*# # #*#*# # # # #*#
#f         x **  *  *   2     #
# # # # # # # # # #*# #*# # # #
#*  *      *  *      *        #
# # # # #*# # # #*#*# # # # # #
#*    **  *       *           #
# #*# # # # # # #*# # # # # # #
#           *   *  *          #
###############################