4 13 31
###############################
#p      * *    * 2 *  * * 1   #
# # # #*# # #*#*# # # #*#*#*# #
#   f     ***  *  3   * 2 * * #
# # # # # #*# # #*#*# # # # #*#
# *          **  *  *   2     #
# # # # # # # # # #*# #*# # # #
#*  f      *  *      *        #
# # # # #*# # # #*#*# #x# # # #
#*    **  *   1   *       1   #
# #*# # # # # # #*# #b# # # # #
#    **     *   *  *  2       #
###############################